Rows: 20
Columns: 20

0 1 1 1 1 1 1 1 1 1 1 1 1 1 1 1 1 1 1 2
3 5 5 5 5 5 5 5 5 5 5 5 5 5 5 5 5 5 5 4
3 5 5 5 5 5 5 5 5 5 5 5 5 5 5 5 5 5 5 4
3 5 5 5 5 9 9 9 9 9 5 5 5 5 5 5 5 5 5 4
3 5 5 5 5 5 5 5 5 9 5 5 5 5 5 5 5 5 5 4
3 5 5 5 5 9 9 5 5 9 5 5 5 5 5 5 5 5 5 4
3 5 5 5 5 5 9 5 5 9 5 5 5 5 5 5 5 10 5 4
3 5 5 5 5 5 9 5 5 9 5 5 5 5 5 5 5 10 5 4
3 5 5 5 5 5 9 5 5 9 5 5 5 5 10 10 10 5 5 4
3 5 5 5 5 5 9 9 9 9 5 5 5 5 10 10 10 5 5 4
3 5 5 5 5 5 5 5 5 5 5 5 5 5 10 10 10 5 5 4
3 5 5 5 5 5 5 5 5 5 5 5 5 5 10 10 10 5 5 4
3 5 5 5 5 5 5 5 5 5 5 5 5 5 10 10 10 5 5 4
3 5 5 5 5 5 5 5 5 5 5 5 5 5 10 10 10 5 5 4
3 5 5 5 5 5 5 5 5 5 5 5 5 5 10 10 10 5 5 4
3 5 5 5 5 5 5 5 5 5 5 5 10 10 10 10 10 5 5 4
3 5 5 5 5 5 5 5 5 5 5 5 5 5 5 5 5 5 5 4
3 5 5 5 5 5 5 5 5 5 5 5 5 5 5 5 5 5 5 4
3 5 5 5 5 5 5 5 5 5 5 5 5 5 5 5 5 5 5 4
6 7 7 7 7 7 7 7 7 7 7 7 7 7 7 7 7 7 7 8